........
........
#######.
........
.#######
........
#######.
........
........